150
020000000000000000000000000000000000000000000000000000000000000000000000000000000000000000000000000000000000000000000000000000000000000000000000000000
010110110110111111111011101111011011111110111111011011111101110101011111111110110110101110101101011011110110111101110101110101010110111111101101010110
011001011101111101110110100011111111111110011011011110111111111011100011100001011101010111100011111111111011010011110111111011111110101111101011101100
011101111101111111111111111110011011110110111111111010101110111101110101011011101011010111011011111110011111101010110111111110010101111111110101101100
010111100111111101111001111011011010001111010110001010011111011011011111010111101111111111110110111101011100110111111110111011101111010111110011101100
001010011010101111011111010100111101111111011101111111011100100111111001110101111111001111011101110110101101101000011111111100011111111111011000110100
010111101101011011110010111011101110011110111101100100111111101011011111111100011111101011001111011101011111111111010110111111111011110100110101111110
011010111110110111101111111110100011011110011111101111101101010110111101110111111010101000110010111111000001010110111001011100111101101011110101110110
001101011111101111111010111111010111010111111111101110111011111111111011001111011001111110110111111110111011101010101111100101110011010110111101110010
011111001111101010111101111111111110110110000011100001110110001111001101011011011010111111011011111011011110111111111111110111110100101101111111010100
011110110111110110111111010111111111011011010111111011010101110101011010111111010111101101000100101110110001110110111111111110111110110111111011101100
011010011111011010011110111010100101110111111100011101110011111100111001000111011110010101011111111101110111011010111110110001100101001111011010110010
000111101100101011101110011001111100101001101110101111011110101110000111011001011001101011001000101111110101011111101101101110101111011101011110010100
011111111101111101011110111101101111011011011011101010110110100111111001010101001111010101110111110001111111011010101111101110010100111010101111011110
001111111110111111000001111111111101111111110101111011011110110111111011010010111110101111111111010110011101001001011110010110101011101111011111101010
011001011001101011011010010111110111010110001110101101011011110011010111110111010110010111100111010001110111101111110110111111110110110010111010111000
011111111101111001111110111000111001111110111001011110111010111011111111101101011101101111111111101101101101111101001101111011101101101101101110101010
010101110011111110010111111101011110111010101011111111101001110111001111100111110011100110110010111011101011010101011101111111011011010011011111010100
001110111111110101011011011111011111101010101111101001011111101101011111101101101111010011111101011011011111111110110101111110101110111100110111001010
010111001111110111011111111011111011111001111011101010111111111111010111100101011110101101101110111101111111111011111010101001101111111101001100110110
001110111111101110111111111111111001101111010111011110110011010110111110101110110011110101111011100100111110100111001110101011011111111111110101101000
010110110011011110001010100111111011011111111000111001001010111110011110011110111111110100011100010111111101010111110101111110101001001011111101010110
001111110111011101101111110100101001110110001011010110100101100011011010111111101111111011111101101111111011101111111010111111110100111010111011110110
011110111101111101011110101101011101101011010101110001010011111110111011100010111111011100110111011101110100011011101101001011101011110111111111011100
011001101011011010111101011010110010101000101111001110110111011011101101010111111000101011101010100011110011011110110111110101011111101001111110101110
001110111101011011111011111010110111101111100111010110110010111011111110101111111111111101100111101111110110101101101101111010111111110110111010101110
010101110101110111111111010111101011101011010110101111010111001011101101111111111100100011111101100000101111100101011111111010111011001001111111110000
011111110110111111111010110100011001110110110101101111111101010111011010111000111110101110111111011110111110011111011111101001101111101101111010101110
011110101111100111110111110111110101101001111011111101111010110110100111110111111111011111000010110101000011101111001010111010111111011111101111101110
000110110101101010111110111100011110111110111101111011111101111111011111111101001110101100111111101011111110011000101001100111101011110110011111011010
010101110100111011011101010110100111110101111111001110100010000101000111001110111011111111000110101111111111110111111011101101111001110010111100111110
001101011111110111110110110110111110111110111100110111111111101111101101111110011000111101110111111101101001101011001110110110111101010111001111101110
011111010111011111101110110011111101101011111111011111001101101011111101101111000110110110110011011011110111111100100001101011110101111000111111110010
011111001101101011100101110101010111111101001110111011011010011011101110101011110011001111111110111111111110111110111111110111011100110111111111110110
011110111111101011101010101111111110100111011010111111001101111100111111011101001111111111011010101010110111110011011010011111111111111111110111111100
010101001001011110011010111011110111010111111001100111111010110011111110111110110111111111011111111111111111111001110111011111100111010010101101110110
010111101011001011101110100110111110110111010110110111001101011011101011101101111111001111111111011110011111110110110010110111111011101111101110010110
011111111111011011011011011010010001011101010101010101010111110110010100010010010011100011111101111110111100101111101011111011010111111110111011111110
010111110110111000111001111010110111111010110101101110111111111001011011101001111100110100111111010010111101010011011100100101011011100111010101111010
000000000000000000000000000000000000000000000000000000000000000000000000000000000000000000000000000000000000000000000000000000000000000000000000000030