150
020000000000000000000000000000000000000000000000000000000000000000000000000000000000000000000000000000000000000000000000000000000000000000000000000000
011001111010111110110000111111110110011100111011100111111101111101111011001011110111110111111111111110101111110111111001111011011101101110100111111110
001111101000111110011111111111111110111111011111010111111111010111001100111101110101011001110111110101110110011111011110111101100111111101101110111000
000101001110111111110011111011110110111001111110101111100110111111001110001001111100011101111111011011011010111100000110110111111111000010001001100110
001100010111100011111101101011101111101010111111111111011110111111111111111100111010001101111110111001010111101110111101111111100110010111110101111110
011011110101011101001010110011111100010110011110110111101110110111101110010011110101101011111011110011111111100110110110010011001010100101011010111100
010110111111011111001011111011011001111011101111001011101110111110110110100110100101111011110101101111110001111100010001110001111110111101111111101110
010111111010111011101110010111110011101011101011111110001111111111111010111111100000011010101111111110111001001101110111010101111011111011111001110010
000011101001110101111111100101101111101010111011010010110011111011111110110101111111110010101110010101000111010111110111110111111011111001111110101110
011101011011101011101111111111110010111011111001010010111111011110111110010111111110111101110100111111101101101010101010010110101111100101111111101010
011111001010101111111000100110111111110111101010011110001101101111001011111111100111011111111111001111111000110010100011011110101111110111111011011010
011111111111111111111101101011110011111111011111110111111011101110111000011111011111011111111001101010111101011101111011100111101111111011111101110100
011101110011001110010111111001101101111110111011001101010110101011101111101100010011101111101011011101111111110000111011101111111100101101111111111100
010111011111111110011111110111111011011101110001111001111110110101110100011011011111111101111101101011001101010111111111011111111111011110101010011010
001111000010100100110111110111110110101110001111111111101001111001011110000110100011111011011111001110010111111111011011101111101001101110101101110110
001101110010011110101010111101111111001000111011111101010111111001101111111101111101001101011010111111111011100001111111010110101111101110101101100100
000110101111101110001010111111010101100111110010111101111110111001011101111111101011111111111001011010111111111111111001100111111001001001110100011100
001001111010110111111111011111111010110001011111011111111111010010111110011011100111010011111111011010111101101001111111101110110011111111011111110110
011101110110010001101111111101111101100101011011101001111001101110101111111111111101101001110001011111001000110111101001000110010111111100010010110000
011110101011011111011010100111011001011101101110111101110011010100000100111010000111010110011101111011010111000110011101111111110111010101011011100010
011011111011110101101010011110011111110011111011110011101101101101100111100010101111100010101101111110101110111011100011101110111111011110010111110110
011111111111011011111001111110011111000111111111111110110111100111101001001110011100111111111101111111010111010101011111001111110010001001101111001110
011011111101100101101110011111010111111101110110111010011011111110100110000011111011101110000101001011110101110100111101010111011011110100110110111010
001110011111100110101101011111111111000111101111011111111111011110110011111101100001111100111110001001110101111011110111111111111111011011101111011110
001111010111001111101111101110111111111110111100111110110111101111001111111101111010011101001111111011111111001111010101111100110111101111110111011110
011010110111110110110100011011110011011111001101110111011110111110101000111111111111111110111011110110111101011101111001010001011001110101110100110000
011110110111010101110111101101111001011110101011111011110111111001110011110100101110101111011011000011001101111100010101111110100111111001010010110110
011001011110001110001101110010001111111111111111000110001111111011111000110110111100011010111010110110110111011111011111100100111101011111111111101110
000101011110110111110110111110111111011111011010111010111110101101111001011111111101110011111001111111100111111111101110101111111101011011011111101110
011111111001111011011010110110011101111111111111000111011101111111111111110110110011000111110111011111001111110010101011110111101011101011111111101110
011001111100100111101011100111110100101011111100010111100001011111111111011101011111100110111111011011001111110111111111111110011101111111111000110100
011010100011111110111110110111111101111110111001101010100111111100110110101111101111001011101101111110011011111011111111011110111111101101011010110000
011011011011110110111111111011011101111011111011110111011011100111011111110111011000100110110111111010101111011100011011001000011101111101011011111110
011011111101101011101111000111110111001011111111111111111111101110001111110101101111111001011111111110011111101110011111110110011101011111110110111110
010111001111101110110001111100011011101011111111111100011111011101111011111101111111111111111011100110101100101011010111101101111111111100100101001100
001110110110111011100101010111101111111011111111011101111101101110111011111111101111111001111011111111110110001111101111101111100111111101111101011110
011110101001110111111100111101110010010011011111001110101001111111101111010100110100111111010011110101101111110100110001111111111111011111111101111110
001111011011111111111111111100111110110101011111100101111111111111110111111011111011011111011011110111101110000110110111010011110011010111101011101110
010011001010100101111110111010111101101111111111101010011111111111110011111111011011101100101110110111111111101011011111100111101000111011010101111000
000000000000000000000000000000000000000000000000000000000000000000000000000000000000000000000000000000000000000000000000000000000000000000000000003000
