150
020000000000000000000000000000000000000000000000000000000000000000000000000000000000000000000000000000000000000000000000000000000000000000000000000000
011110111111110011110110000111001111101111011110010010011101001111111111101110110001111101110110011111101111011011101101111111111100110110111110111110
011011010011011011111001011111100011111101111111001100100111011011001011100011011101101010010111110011011011110111111111001010001011110111111001111010
011101110000111111101011011011001011001110111111011111101111111101111111111101011111111001110101111111011100101001110101101111110101111101111110010100
010011110101011111001110011101111001111110101011111111010101000000111110100110000111101110111111011101111111011111111000101110111111111100011111101010
011101001111111011111101101010100111011111111111111111110011110111101110110110110111110011111111001011101111010011011011011110000111100110101110111110
011101011100010111111011011001110001111101110111001110010110100101010111001111111111000011111100011101011100110010110110111100111010111111111011011100
011100010010011010110000011110111000111111110110111010100011110111111011111110011010101111000110001011101000101011100011101011011000101001101101111110
010110101101101101110110111111010111110110101111111100100111001011111101011101001110001111111101110011100010101110101111100010100110100011001111010110
010001111100111111001101100100110100010100111111011100111111011111111011100101000101100101111000000101110111111110011111010111101001011111000011000110
001111110101111101011101111111100001010111010111101011100001111100101110111110001110111111111101111101111110101010111001111100000011110101000111101110
011011111000111111001111101100110101111101011101110001111101111111101111001011100111100111110010100110010100110101011101010111111011110110111001111000
011111111111000110101110111011111100100001110100010111000011111011110111111110110011001110001111111111100111111101001010010011111010100110110110111100
001011101010111101001110010111110111101111011111111111101010011011100101111101011011101010111011011010011111111011010101011011111111111101110010010010
001111101101111101011111110000011011011111100110101010110011110111110111011001111101101111001010000111011001011111111101111011111111111011110110111100
001111001110011011100111011111111011110011101111001111011000110110110100010101101111011011111101111001011101111011011011111101100001111101011011000100
011010111111101111111011111111100101101111110000001011101111111101101111110110011111110110101010111111110111001111100101010110010111111111111010110110
011111100110111111111111111111011011011110101110010000101010010100111111111011010110111110010111111100111111001111111101101111101110111111110011101110
011110110011101101111111101000001111111011111011111000110001011001100110011011011110111100101111110111111011011111110010001011011111011111111111111100
010111111100110111111101100100111100111010010101010011110000111011011011001111100101100110101111110101111011001010011100110111111111011010111101100110
011111011010100111011111110111011010111010111110011010101011111111110111101010101111101111110111011010111101011111101010111011010110111110010111101110
010111111101111111111110011011110010100101111111001110101101101111001101111111111001101111111110010110100111011010110111111111011111101011111101101010
010000011111101101100100011111101100111101110101111100111100110111110111100111000011011111001110111001111101011111001111011111110110011011111110110010
001111010010011100110011110000111000111101100110111010111111110111010011111101100101111011101101010011101111111111111111110111101011001111111011011010
010111111001011101010111111001011100111111001011111010011111111011111111111011111111111111101001011111001111110101101111010110111111111011111110110010
011101011010101011011111111110110001111111111110011011000111111110111111101111101111111111001011110111111101110111110101011011101011101101110110111110
011111101110101110111111110101111011111010011110111111110001011011110110010101111111111111110000100111110110111111100001111000100110110110011111111010
001100001111101111011111111111011111110011111110101111110100011000001111001111111111101111110111111110110111011010101110011111111110111001110111111000
010110111111011011010111000111110011100000111110111011111101100111100110011110011010111111110011101101111111011000110011111110111101011011111101111100
010111010101100110001110001010000111100101011111111111001101011001011000110100010110010001100110111101111011111111111101100111010001101000111101111110
011111110101001111111111010111000111101001101110011101110111011111100100111111001010101110101111111110100000110110101100111111011111011111111100101110
011100110111111011101110011011111010111110111111010101011110111011010100001111111111011110011111111010011110101011101110111010110110010111100001001110
011011111100010111111001101011100111011111011110010100011110010001111110011101011011101111100101000111001111010100110010010101001001110010110011011110
011111011011101011110101111110110011101111111101111110011011110100110111011101011111111111111101111010011111111100111001010101111100001101111111111110
001011011011100011111010011111011110100111111111001111111101011101111000101010011110101111110011110011111011111010111010111010111111100011100111101100
001010010101111100110111000111010110001100100110101110000111000100110111111100111011111111010111101111011101011101111100111111001101111101111111101110
011000001011011001100111101111101011111010000110110100111111100011111100101001010101110011111100111100100101010110011011110110111111111100111111111110
010110001110101111101111000011010011001101111111110001110010111101110111101001110011111111111011011111110110111111110101000101110010111011111011101010
011001101110110111111111111111110110111001001111111100011101000011100111111001100011111111111011111010010111111101111110111011111111011111001101011110
000000000000000000000000000000000000000000000000000000000000000000000000000000000000000000000000000000000000000000000000000000000000000000000000000030
